1111111111
1        2
1        2
12222222 2
1        2
1  3335332
1  1     2
1  22254 2
1        2
3333333333