1111111111
1        2
1        2
12222222 2
1        2
1 33333332
1 1      2
1 555554 2
1        2
3333333333